
                 #  #### ###########       ##                  #
##  ################## ###   ####           ###### #############################
           ##########  ####            #  ## ##########################    ##
             ##############             ### ###  ## ###################
              #########                ####     ###################  #
                 ##   #              #################  ##########
                     #  #            ############# #     #    ###
                       #######             #######             # ##  #
                       #########            #####                    #
                         ######             ####  #               ########
                         ####                #                    ##  ####
                        ##                                                    #

                         #                         ####    ##############
    # ################       ## ############################################